synth1: 
réaliser -> réalisé
aurez -> on a
sont bien configurés-> on a bien configuré
vous pouvez affichez -> on affiché
débranchez2-> on a débranché 
Importez ->   on a importé
inspectez ->  on a inspectez
affichez -> on a affiché

visualisez -> on a visualisé
afficher -> on a affiché

la création -> on a créé
   •   Le formater -> on a formaté
   •   Le monter  -> on a monté
démontez -> on a démonté
 
synth2: 

ensuite un VG  nommé vgstockage -> ensuite on a nommé un VG en tant que vgstockage
nommé -> on a nommé 
 

Pour l’instant votre VG est composé -> Pour l’instant notre VG est composé de
votre -> notre


créer -> créé
Configurez -> on a configuré
augmentez -> on a augmenté
ne le sait pas -> on ne le savait pas


Comparez -> on a comparé

utiliser -> on a utilisé

vous devez étendre -> on a étendu
étendre -> on a étendu

pour vérifier -> on a vérifié
vérifier -> on a vérifié
allouer -> on a alloué



------ ++ for more pattern to grep /sed in the future
sait pas -> on sait 
vous devez étendre -> on étend
étendre -> on étend